fin_claim_id,fin_exp_id,fin_remaining_reserves,fin_total_paid,fin_total_recoveries,fin_net_total_incurred
CLM01-1007916,EXP01-10001,3817,5701,5158,543
CLM01-1008279,EXP01-10003,4704,789,638,151
CLM01-1006316,EXP01-10002,4607,508,507,1
CLM01-1005185,EXP01-10001,659,4778,714,4064
CLM01-1004258,EXP01-10004,6114,2287,1394,893
CLM01-1008061,EXP01-10001,808,9018,7013,2005
CLM01-1010251,EXP01-10005,3860,8869,4451,4418
CLM01-1004502,EXP01-10004,4558,6931,4867,2064
CLM01-1009111,EXP01-10004,5385,4633,1164,3469
CLM01-1008386,EXP01-10001,2408,3038,1232,1806
CLM01-1001920,EXP01-10001,4572,1229,521,708
CLM01-1001213,EXP01-10003,2505,8583,1026,7557
CLM01-1009682,EXP01-10005,4381,9158,4523,4635
CLM01-1009996,EXP01-10003,2721,5651,3160,2491
CLM01-1003350,EXP01-10002,9591,5415,3692,1723
CLM01-1006800,EXP01-10003,3710,8688,1567,7121
CLM01-1001937,EXP01-10005,5353,4882,2898,1984
CLM01-1001206,EXP01-10004,5249,3345,1162,2183
CLM01-1007851,EXP01-10001,1551,8937,3251,5686
CLM01-1010269,EXP01-10004,8096,9595,8738,857
CLM01-1005247,EXP01-10002,5369,4815,1256,3559
CLM01-1007203,EXP01-10001,9770,3541,1634,1907
CLM01-1009753,EXP01-10002,5269,5543,574,4969
CLM01-1002741,EXP01-10002,9594,929,693,236
CLM01-1003267,EXP01-10001,7512,769,570,199
CLM01-1002429,EXP01-10003,7102,4685,3022,1663
CLM01-1010843,EXP01-10002,6319,9538,9494,44
CLM01-1009147,EXP01-10005,8096,2239,2045,194
CLM01-1002806,EXP01-10005,1272,5506,2081,3425
CLM01-1000272,EXP01-10005,811,5642,1792,3850
CLM01-1009214,EXP01-10004,3306,7163,2462,4701
CLM01-1008346,EXP01-10001,3154,9810,9363,447
CLM01-1005984,EXP01-10001,8274,2984,515,2469
CLM01-1007924,EXP01-10001,9832,3984,3283,701
CLM01-1001555,EXP01-10002,1249,3150,2655,495
CLM01-1009401,EXP01-10004,1901,1177,549,628
CLM01-1009312,EXP01-10003,4546,9403,2687,6716
CLM01-1008129,EXP01-10001,4820,5485,696,4789
CLM01-1002260,EXP01-10003,1281,7507,7227,280
CLM01-1000607,EXP01-10003,4462,7240,3728,3512
CLM01-1005192,EXP01-10004,3544,1071,955,116
CLM01-1000081,EXP01-10002,3296,9840,1952,7888
CLM01-1008161,EXP01-10003,5703,3886,2514,1372
CLM01-1000262,EXP01-10005,5144,6253,1907,4346
CLM01-1003984,EXP01-10001,8408,7337,7119,218
CLM01-1009020,EXP01-10001,9178,2579,1631,948
CLM01-1000260,EXP01-10005,3561,3714,1196,2518
CLM01-1002243,EXP01-10004,3732,4931,1759,3172
CLM01-1002365,EXP01-10001,654,9602,9295,307
CLM01-1001995,EXP01-10003,1953,3840,3471,369
CLM01-1007480,EXP01-10003,634,7483,3909,3574
CLM01-1010434,EXP01-10003,8181,2717,1943,774
CLM01-1010356,EXP01-10005,3942,1013,966,47
CLM01-1007828,EXP01-10004,1685,7202,499,6703
CLM01-1001599,EXP01-10001,7157,3824,1731,2093
CLM01-1008211,EXP01-10005,1578,6304,1294,5010
CLM01-1003506,EXP01-10003,7373,576,524,52
CLM01-1002822,EXP01-10005,9484,9882,1936,7946
CLM01-1005714,EXP01-10003,5721,1630,1171,459
CLM01-1009067,EXP01-10005,7590,3818,1858,1960
CLM01-1006615,EXP01-10001,4702,3716,1349,2367
CLM01-1010930,EXP01-10005,8516,2427,824,1603
CLM01-1009047,EXP01-10002,6248,4611,1375,3236
CLM01-1005144,EXP01-10005,6935,5218,4038,1180
CLM01-1007590,EXP01-10004,8137,6325,4380,1945
CLM01-1005522,EXP01-10004,8505,7094,2919,4175
CLM01-1006455,EXP01-10004,900,5054,2281,2773
CLM01-1007810,EXP01-10004,2511,3297,2237,1060
CLM01-1009949,EXP01-10005,1389,6435,4784,1651
CLM01-1007299,EXP01-10005,5249,9693,2876,6817
CLM01-1006030,EXP01-10002,7851,9506,638,8868
CLM01-1007091,EXP01-10005,5964,1392,1222,170
CLM01-1001513,EXP01-10002,7016,3276,1902,1374
CLM01-1001415,EXP01-10002,6492,4140,2650,1490
CLM01-1008649,EXP01-10003,6228,2118,1010,1108
CLM01-1006704,EXP01-10003,5194,6797,4442,2355
CLM01-1007310,EXP01-10002,838,8347,5134,3213
CLM01-1005837,EXP01-10002,4432,9093,7695,1398
CLM01-1000079,EXP01-10002,3324,4649,3431,1218
CLM01-1004632,EXP01-10002,2849,6837,3683,3154
CLM01-1000018,EXP01-10005,6083,1651,878,773
CLM01-1003000,EXP01-10003,8454,8283,6069,2214
CLM01-1006375,EXP01-10002,5659,842,686,156
CLM01-1004176,EXP01-10001,6783,5337,2185,3152
CLM01-1004503,EXP01-10004,3004,5632,2551,3081
CLM01-1002905,EXP01-10003,1024,1710,688,1022
CLM01-1006534,EXP01-10005,8744,8660,6143,2517
CLM01-1003367,EXP01-10004,2636,7156,3502,3654
CLM01-1004120,EXP01-10002,9049,5124,4983,141
CLM01-1000189,EXP01-10003,8516,2983,2113,870
CLM01-1008254,EXP01-10004,555,7131,6227,904
CLM01-1004767,EXP01-10002,8922,9788,7522,2266
CLM01-1006136,EXP01-10001,7681,6712,5152,1560
CLM01-1004512,EXP01-10001,3992,1250,958,292
CLM01-1009146,EXP01-10001,4656,5178,2138,3040
CLM01-1002690,EXP01-10001,6660,2906,602,2304
CLM01-1008135,EXP01-10003,3997,3367,1430,1937
CLM01-1008384,EXP01-10003,9818,2629,1758,871
CLM01-1008393,EXP01-10003,5237,4644,617,4027
CLM01-1004797,EXP01-10004,9067,8736,3241,5495
CLM01-1004800,EXP01-10005,9280,7559,3591,3968
CLM01-1004092,EXP01-10002,8077,2806,1754,1052
CLM01-1010145,EXP01-10001,4369,1880,1665,215
CLM01-1005390,EXP01-10003,9376,3095,626,2469
CLM01-1002872,EXP01-10001,3911,8541,3773,4768
CLM01-1006101,EXP01-10005,6189,8227,3523,4704
CLM01-1010306,EXP01-10005,8681,9444,879,8565
CLM01-1003281,EXP01-10001,1195,6117,1052,5065
CLM01-1002322,EXP01-10005,4283,6723,1994,4729
CLM01-1004376,EXP01-10005,5158,5396,1254,4142
CLM01-1003512,EXP01-10004,7438,1357,676,681
CLM01-1003419,EXP01-10002,8304,1440,1049,391
CLM01-1006011,EXP01-10001,9966,1519,1304,215
CLM01-1010432,EXP01-10005,1877,9147,5379,3768
CLM01-1008373,EXP01-10003,8556,5068,4976,92
CLM01-1005384,EXP01-10001,4190,6871,1775,5096
CLM01-1000532,EXP01-10002,2426,3089,1773,1316
CLM01-1010149,EXP01-10004,869,9609,2152,7457
CLM01-1004098,EXP01-10004,7998,2900,2802,98
CLM01-1006933,EXP01-10004,2880,6159,2872,3287
CLM01-1005524,EXP01-10003,1874,5236,666,4570
CLM01-1009694,EXP01-10001,8732,7908,4132,3776
CLM01-1004124,EXP01-10004,4584,511,503,8
CLM01-1000209,EXP01-10002,5137,5212,3093,2119
CLM01-1008039,EXP01-10004,6350,633,619,14
CLM01-1004259,EXP01-10003,4534,8779,3064,5715
CLM01-1005935,EXP01-10002,1682,3487,3207,280
CLM01-1010969,EXP01-10005,8632,8624,8345,279
CLM01-1004292,EXP01-10002,5250,5252,1574,3678
CLM01-1006508,EXP01-10001,6106,4788,3097,1691
CLM01-1006022,EXP01-10003,8154,727,593,134
CLM01-1007250,EXP01-10003,8732,5887,5364,523
CLM01-1003203,EXP01-10002,1160,8594,6990,1604
CLM01-1008750,EXP01-10001,1068,8788,3799,4989
CLM01-1002529,EXP01-10004,4471,4078,1598,2480
CLM01-1008633,EXP01-10004,631,6780,3698,3082
CLM01-1008447,EXP01-10003,2542,8207,7516,691
CLM01-1007754,EXP01-10005,7506,4842,4613,229
CLM01-1009555,EXP01-10003,2165,5694,1612,4082
CLM01-1003133,EXP01-10003,1673,8504,8099,405
CLM01-1008837,EXP01-10001,3859,5238,4922,316
CLM01-1004568,EXP01-10005,9803,5439,5193,246
CLM01-1010311,EXP01-10001,2521,5288,1208,4080
CLM01-1006668,EXP01-10004,6718,8285,7976,309
CLM01-1002926,EXP01-10001,3700,9652,3828,5824
CLM01-1005095,EXP01-10005,3926,2255,2203,52
CLM01-1000990,EXP01-10001,2962,9531,4666,4865
CLM01-1000479,EXP01-10002,4643,1235,937,298
CLM01-1002645,EXP01-10005,3870,8902,2135,6767
CLM01-1004897,EXP01-10003,2447,8830,6022,2808
CLM01-1005800,EXP01-10004,1194,5650,2342,3308
CLM01-1007869,EXP01-10005,4473,6796,4365,2431
CLM01-1003412,EXP01-10005,9154,7192,6355,837
CLM01-1001512,EXP01-10005,650,9475,1870,7605
CLM01-1010400,EXP01-10001,5250,9108,4276,4832
CLM01-1007094,EXP01-10005,5355,4097,779,3318
CLM01-1002453,EXP01-10005,1516,9471,3571,5900
CLM01-1006189,EXP01-10005,5128,9582,7608,1974
CLM01-1005181,EXP01-10005,1988,5403,2590,2813
CLM01-1006077,EXP01-10005,6598,4839,2870,1969
CLM01-1004781,EXP01-10002,3511,8604,760,7844
CLM01-1005370,EXP01-10001,5732,5421,5231,190
CLM01-1007480,EXP01-10003,4707,9172,1986,7186
CLM01-1005026,EXP01-10005,8825,8128,1071,7057
CLM01-1005005,EXP01-10001,8936,1617,1420,197
CLM01-1007424,EXP01-10003,4452,1045,533,512
CLM01-1007442,EXP01-10004,1930,8331,7554,777
CLM01-1002691,EXP01-10004,4113,6193,5704,489
CLM01-1006660,EXP01-10003,4236,5615,3582,2033
CLM01-1004223,EXP01-10001,7551,3377,730,2647
CLM01-1003212,EXP01-10004,2449,6312,1109,5203
CLM01-1009995,EXP01-10003,8903,2877,2835,42
CLM01-1001202,EXP01-10005,4315,9280,8255,1025
CLM01-1000701,EXP01-10003,2927,1070,653,417
CLM01-1010150,EXP01-10002,6597,9320,3845,5475
CLM01-1010440,EXP01-10005,7778,3036,1309,1727
CLM01-1004085,EXP01-10005,3409,1192,655,537
CLM01-1008087,EXP01-10003,8013,9130,6965,2165
CLM01-1007642,EXP01-10004,4742,3205,2175,1030
CLM01-1004919,EXP01-10002,9216,4476,3210,1266
CLM01-1002777,EXP01-10001,6598,1306,977,329
CLM01-1007615,EXP01-10002,7179,9731,5918,3813
CLM01-1008257,EXP01-10003,6043,9448,1225,8223
CLM01-1002844,EXP01-10001,1565,3433,1442,1991
CLM01-1002985,EXP01-10003,8486,8198,6904,1294
CLM01-1000359,EXP01-10005,9989,3753,2289,1464
CLM01-1009914,EXP01-10004,9753,4783,3542,1241
CLM01-1002094,EXP01-10003,3517,2256,1077,1179
CLM01-1004022,EXP01-10002,4496,3313,2538,775
CLM01-1006240,EXP01-10001,4942,604,501,103
CLM01-1009839,EXP01-10003,5944,512,509,3
CLM01-1003519,EXP01-10002,9673,3944,3470,474
CLM01-1004579,EXP01-10003,3591,6194,2817,3377
CLM01-1005757,EXP01-10002,9195,2991,587,2404
CLM01-1010472,EXP01-10005,9945,2006,830,1176
CLM01-1007362,EXP01-10004,8148,5383,4025,1358
CLM01-1001943,EXP01-10005,8384,2840,2327,513
CLM01-1002795,EXP01-10004,3651,4648,1894,2754
CLM01-1001761,EXP01-10005,933,6790,1586,5204
CLM01-1004775,EXP01-10001,8204,6548,982,5566
CLM01-1003903,EXP01-10001,1387,4853,1342,3511
CLM01-1004021,EXP01-10002,6638,4396,1948,2448
CLM01-1002079,EXP01-10001,5110,7510,2230,5280
CLM01-1003328,EXP01-10003,3665,1345,1128,217
CLM01-1003847,EXP01-10004,4318,1116,785,331
CLM01-1001308,EXP01-10002,6545,8295,519,7776
CLM01-1004977,EXP01-10001,2008,6126,4703,1423
CLM01-1004636,EXP01-10004,539,9492,1999,7493
CLM01-1010150,EXP01-10002,6781,6868,1097,5771
CLM01-1003104,EXP01-10005,3356,3158,2935,223
CLM01-1010413,EXP01-10004,5872,9619,7767,1852
CLM01-1005132,EXP01-10004,669,5560,5204,356
CLM01-1005697,EXP01-10001,7475,9125,7039,2086
CLM01-1004161,EXP01-10004,7400,4085,782,3303
CLM01-1010826,EXP01-10005,1162,8667,2033,6634
CLM01-1005464,EXP01-10002,9600,4654,1920,2734
CLM01-1001912,EXP01-10004,7794,9944,1321,8623
CLM01-1003065,EXP01-10005,1843,6468,5610,858
CLM01-1002687,EXP01-10004,5244,2425,1566,859
CLM01-1006043,EXP01-10004,9017,4846,2724,2122
CLM01-1001773,EXP01-10003,7416,6631,1466,5165
CLM01-1008043,EXP01-10002,863,7852,6048,1804
CLM01-1005809,EXP01-10001,8335,7089,4436,2653
CLM01-1010267,EXP01-10001,8078,6626,1059,5567
CLM01-1004510,EXP01-10005,8039,5285,4247,1038
CLM01-1007080,EXP01-10002,7188,3914,3174,740
CLM01-1000350,EXP01-10002,5707,1014,865,149
CLM01-1007957,EXP01-10004,3577,8668,3415,5253
CLM01-1002441,EXP01-10001,1842,4458,671,3787
CLM01-1006285,EXP01-10003,8808,8398,7636,762
CLM01-1006112,EXP01-10001,5010,3862,3437,425
CLM01-1008495,EXP01-10001,6276,7808,801,7007
CLM01-1009626,EXP01-10001,5794,1763,1525,238
CLM01-1010086,EXP01-10004,2140,4166,1608,2558
CLM01-1002531,EXP01-10005,5493,8066,2611,5455
CLM01-1007189,EXP01-10002,2690,4345,3016,1329
CLM01-1005850,EXP01-10004,5500,4603,998,3605
CLM01-1005334,EXP01-10002,9067,3979,3610,369
CLM01-1002716,EXP01-10001,1882,2544,2179,365
CLM01-1007290,EXP01-10005,3687,6326,1062,5264
CLM01-1008399,EXP01-10005,916,1641,1041,600
CLM01-1010814,EXP01-10001,3260,5912,5452,460
CLM01-1004561,EXP01-10003,8017,8859,3837,5022
CLM01-1005579,EXP01-10005,8615,5494,4738,756
CLM01-1007558,EXP01-10002,1395,552,534,18
CLM01-1006073,EXP01-10005,4873,5807,1938,3869
CLM01-1009407,EXP01-10004,2210,4955,2243,2712
CLM01-1002007,EXP01-10003,4917,5249,1705,3544
CLM01-1008782,EXP01-10003,9948,8509,2662,5847
CLM01-1008710,EXP01-10004,911,5543,3017,2526
CLM01-1008750,EXP01-10001,2887,7777,4297,3480
CLM01-1000256,EXP01-10005,2830,3762,1705,2057
CLM01-1007126,EXP01-10005,9259,966,593,373
CLM01-1007444,EXP01-10003,9640,7119,1815,5304
CLM01-1005068,EXP01-10002,5318,7499,6007,1492
CLM01-1010309,EXP01-10003,6428,6021,2687,3334
CLM01-1008872,EXP01-10004,3696,4674,3553,1121
CLM01-1010538,EXP01-10004,2660,7262,1476,5786
CLM01-1009563,EXP01-10004,1956,4080,1521,2559
CLM01-1007833,EXP01-10003,2827,5594,1057,4537
CLM01-1010887,EXP01-10005,2882,3258,1054,2204
CLM01-1002187,EXP01-10001,550,9109,2239,6870
CLM01-1006534,EXP01-10005,5587,8610,3771,4839
CLM01-1009301,EXP01-10005,7658,7736,1030,6706
CLM01-1007219,EXP01-10004,8614,920,645,275
CLM01-1003227,EXP01-10003,8434,1206,771,435
CLM01-1005838,EXP01-10003,9699,1754,705,1049
CLM01-1008919,EXP01-10003,6517,7409,4612,2797
CLM01-1009372,EXP01-10002,8841,7587,6599,988
CLM01-1004330,EXP01-10003,9921,1887,1348,539
CLM01-1002363,EXP01-10004,6585,1669,612,1057
CLM01-1001718,EXP01-10005,9089,5580,2448,3132
CLM01-1009983,EXP01-10002,3650,597,555,42
CLM01-1000192,EXP01-10001,1777,3177,534,2643
CLM01-1006073,EXP01-10005,8610,4364,4320,44
CLM01-1004576,EXP01-10001,1619,2474,675,1799
CLM01-1002919,EXP01-10002,9023,7653,4233,3420
CLM01-1004365,EXP01-10004,7506,7245,3623,3622
CLM01-1001066,EXP01-10004,5364,8803,3936,4867
CLM01-1001774,EXP01-10004,3821,6245,3993,2252
CLM01-1009715,EXP01-10001,9581,8745,3680,5065
CLM01-1000139,EXP01-10001,8001,5184,1729,3455
CLM01-1008884,EXP01-10005,9031,4177,4159,18
CLM01-1008027,EXP01-10004,3170,9451,8236,1215
CLM01-1007001,EXP01-10002,5018,1268,1195,73
CLM01-1010484,EXP01-10002,5110,4118,1161,2957
CLM01-1009548,EXP01-10004,3483,7618,3165,4453
CLM01-1009362,EXP01-10003,9928,1902,582,1320
CLM01-1002741,EXP01-10002,8731,3399,2472,927
CLM01-1000145,EXP01-10004,2268,2229,1342,887
CLM01-1004413,EXP01-10003,9533,7258,1031,6227
CLM01-1002653,EXP01-10002,3476,4794,4333,461
CLM01-1010942,EXP01-10003,1168,3568,877,2691
CLM01-1003401,EXP01-10003,677,1139,620,519
CLM01-1009879,EXP01-10001,7489,3932,2544,1388
CLM01-1004091,EXP01-10005,1855,6829,4341,2488
CLM01-1010997,EXP01-10004,2145,6662,1669,4993
CLM01-1002226,EXP01-10004,3298,5223,1759,3464
CLM01-1001799,EXP01-10005,9119,1314,565,749
CLM01-1009530,EXP01-10001,3576,2477,1649,828
CLM01-1008169,EXP01-10003,1869,2512,1709,803
CLM01-1006650,EXP01-10004,5612,1456,658,798
CLM01-1003641,EXP01-10005,8783,554,501,53
CLM01-1000073,EXP01-10002,6414,5540,3221,2319
CLM01-1003721,EXP01-10003,7629,1867,1169,698
CLM01-1008487,EXP01-10005,6123,9602,1066,8536
CLM01-1008320,EXP01-10003,2307,7601,6514,1087
CLM01-1005154,EXP01-10001,7601,6863,4423,2440
CLM01-1008649,EXP01-10003,9689,9925,7490,2435
CLM01-1003900,EXP01-10005,9488,7415,1358,6057
CLM01-1007853,EXP01-10004,6379,5272,601,4671
CLM01-1008964,EXP01-10004,1385,1284,1152,132
CLM01-1005108,EXP01-10003,4033,9347,6788,2559
CLM01-1001713,EXP01-10004,7049,2437,1910,527
CLM01-1003151,EXP01-10002,3712,8983,916,8067
CLM01-1001908,EXP01-10001,1721,9874,1371,8503
CLM01-1001862,EXP01-10005,5217,5949,1075,4874
CLM01-1010358,EXP01-10005,5548,7329,972,6357
CLM01-1009030,EXP01-10004,5589,6671,3738,2933
CLM01-1004479,EXP01-10004,7133,5083,2838,2245
CLM01-1005487,EXP01-10004,1279,3952,3689,263
CLM01-1003501,EXP01-10002,2200,5091,956,4135
CLM01-1009768,EXP01-10005,8368,6863,3252,3611
CLM01-1006649,EXP01-10004,9591,3531,2905,626
CLM01-1006594,EXP01-10005,4012,3427,1384,2043
CLM01-1002291,EXP01-10003,8441,6856,751,6105
CLM01-1006133,EXP01-10004,9430,4418,2303,2115
CLM01-1010814,EXP01-10001,3403,9763,9148,615
CLM01-1005426,EXP01-10004,5921,8375,3886,4489
CLM01-1001075,EXP01-10005,9409,2167,1943,224
CLM01-1003453,EXP01-10003,5118,7775,3272,4503
CLM01-1006402,EXP01-10005,5209,1443,638,805
CLM01-1009414,EXP01-10005,7818,8227,2992,5235
CLM01-1004289,EXP01-10004,6547,952,699,253
CLM01-1000424,EXP01-10001,5000,3455,2531,924
CLM01-1001007,EXP01-10002,8615,8724,5300,3424
CLM01-1008637,EXP01-10004,971,9548,3415,6133
CLM01-1007587,EXP01-10004,3338,8207,7369,838
CLM01-1009996,EXP01-10003,7404,5562,1918,3644
CLM01-1010966,EXP01-10002,3633,5594,1679,3915
CLM01-1009104,EXP01-10004,2342,2476,803,1673
CLM01-1004646,EXP01-10001,7517,6403,4497,1906
CLM01-1000196,EXP01-10005,6827,5310,1500,3810
CLM01-1000510,EXP01-10003,617,8754,4490,4264
CLM01-1008175,EXP01-10005,1514,8295,516,7779
CLM01-1008789,EXP01-10001,7314,9907,7398,2509
CLM01-1000238,EXP01-10004,5693,4945,2120,2825
CLM01-1004028,EXP01-10005,871,4104,805,3299
CLM01-1000174,EXP01-10005,5634,3348,2307,1041
CLM01-1007100,EXP01-10004,8132,9939,3468,6471
CLM01-1006881,EXP01-10003,2291,664,635,29
CLM01-1009134,EXP01-10002,7600,4958,2062,2896
CLM01-1010605,EXP01-10004,9746,5301,5180,121
CLM01-1000870,EXP01-10004,8306,7750,3179,4571
CLM01-1004202,EXP01-10005,7474,7670,769,6901
CLM01-1006732,EXP01-10004,1216,1181,560,621
CLM01-1004312,EXP01-10003,4088,7302,1697,5605
CLM01-1003431,EXP01-10001,5642,8823,7919,904
CLM01-1010507,EXP01-10003,5687,3415,613,2802
CLM01-1009334,EXP01-10005,1373,3090,2646,444
CLM01-1008295,EXP01-10001,9010,9394,1832,7562
CLM01-1000764,EXP01-10003,1564,1314,1235,79
CLM01-1004791,EXP01-10003,818,7235,4422,2813
CLM01-1001921,EXP01-10001,3695,7606,5216,2390
CLM01-1003355,EXP01-10002,8575,3602,656,2946
CLM01-1004508,EXP01-10005,2332,706,663,43
CLM01-1009294,EXP01-10004,2392,2167,1053,1114
CLM01-1003737,EXP01-10005,8548,2266,1279,987
CLM01-1000252,EXP01-10005,987,7354,3870,3484
CLM01-1006073,EXP01-10005,1039,5921,3986,1935
CLM01-1000494,EXP01-10001,9068,2574,805,1769
CLM01-1004185,EXP01-10003,1167,8796,4253,4543
CLM01-1003557,EXP01-10001,9326,503,500,3
CLM01-1008836,EXP01-10001,1995,4256,3069,1187
CLM01-1001674,EXP01-10003,5537,9409,2053,7356
CLM01-1003255,EXP01-10004,5974,2371,1546,825
CLM01-1006275,EXP01-10004,6019,4044,1123,2921
CLM01-1007713,EXP01-10001,1536,7128,1927,5201
CLM01-1001297,EXP01-10002,9704,2031,850,1181
CLM01-1010635,EXP01-10005,7048,3434,1923,1511
CLM01-1000031,EXP01-10004,9921,901,866,35
CLM01-1001002,EXP01-10001,9555,3393,1911,1482
CLM01-1000995,EXP01-10003,6834,5832,2233,3599
CLM01-1005542,EXP01-10002,8603,6988,1212,5776
CLM01-1004192,EXP01-10004,7117,1076,949,127
CLM01-1004851,EXP01-10004,4906,4000,1017,2983
CLM01-1010689,EXP01-10005,5187,6816,5945,871
CLM01-1009227,EXP01-10004,8960,6793,5195,1598
CLM01-1009805,EXP01-10004,816,7390,7202,188
CLM01-1009887,EXP01-10002,9725,9640,8889,751
CLM01-1008748,EXP01-10002,2509,2748,1068,1680
CLM01-1000521,EXP01-10003,5335,6714,3793,2921
CLM01-1002467,EXP01-10005,3718,5945,2314,3631
CLM01-1002448,EXP01-10005,5449,6249,2818,3431
CLM01-1006694,EXP01-10002,1619,902,766,136
CLM01-1006279,EXP01-10003,3047,5436,821,4615
CLM01-1003133,EXP01-10003,8745,2593,1533,1060
CLM01-1010745,EXP01-10005,5647,648,574,74
CLM01-1008443,EXP01-10002,5811,7318,5993,1325
CLM01-1010705,EXP01-10003,2671,4191,1896,2295
CLM01-1007341,EXP01-10004,6595,5623,4793,830
CLM01-1009552,EXP01-10005,7846,5875,4864,1011
CLM01-1010941,EXP01-10003,7800,5893,3634,2259
CLM01-1005303,EXP01-10005,1589,8314,2266,6048
CLM01-1010159,EXP01-10003,3770,6615,3453,3162
CLM01-1007359,EXP01-10002,4984,7686,6555,1131
CLM01-1008668,EXP01-10003,1137,3581,2001,1580
CLM01-1005462,EXP01-10003,728,1353,1152,201
CLM01-1006998,EXP01-10005,7573,8017,1243,6774
CLM01-1002981,EXP01-10005,4309,7250,3555,3695
CLM01-1005735,EXP01-10001,7373,3160,2859,301
CLM01-1002971,EXP01-10004,6574,2227,1944,283
CLM01-1010349,EXP01-10003,3403,2745,1552,1193
CLM01-1007832,EXP01-10003,7897,8576,2887,5689
CLM01-1001492,EXP01-10005,8113,904,800,104
CLM01-1006960,EXP01-10001,9510,751,744,7
CLM01-1003424,EXP01-10003,3831,8866,7083,1783
CLM01-1008938,EXP01-10002,6270,8170,1164,7006
CLM01-1009514,EXP01-10003,755,8346,904,7442
CLM01-1004519,EXP01-10002,5766,8897,8750,147
CLM01-1009998,EXP01-10003,8782,8517,3181,5336
CLM01-1001075,EXP01-10005,9974,3619,997,2622
CLM01-1006042,EXP01-10005,919,6972,5899,1073
CLM01-1005266,EXP01-10003,8537,3141,1831,1310
CLM01-1009543,EXP01-10005,3582,1475,839,636
CLM01-1004973,EXP01-10003,2475,1993,699,1294
CLM01-1010361,EXP01-10002,9057,7766,2490,5276
CLM01-1009376,EXP01-10004,2197,7784,5040,2744
CLM01-1008978,EXP01-10003,7678,8396,7222,1174
CLM01-1002396,EXP01-10003,4269,845,553,292
CLM01-1009334,EXP01-10005,3458,3583,2105,1478
CLM01-1006672,EXP01-10002,1144,7138,1158,5980
CLM01-1010433,EXP01-10004,1358,1425,1422,3
CLM01-1007611,EXP01-10003,4676,7565,5980,1585
CLM01-1008597,EXP01-10001,5497,8787,4853,3934
CLM01-1010437,EXP01-10002,8383,1558,818,740
CLM01-1000171,EXP01-10003,5797,8519,3273,5246
CLM01-1004607,EXP01-10005,7363,5400,1813,3587
CLM01-1002386,EXP01-10002,2939,3849,1650,2199
CLM01-1003769,EXP01-10003,1018,868,812,56
CLM01-1005107,EXP01-10005,8056,2084,1678,406
CLM01-1008775,EXP01-10005,3489,6755,4291,2464
CLM01-1005976,EXP01-10001,3107,3258,1658,1600
CLM01-1008395,EXP01-10005,9161,2654,2110,544
CLM01-1005442,EXP01-10003,4385,4319,2960,1359
CLM01-1010430,EXP01-10001,8786,9477,6995,2482
CLM01-1007636,EXP01-10002,4397,5070,4789,281
CLM01-1000414,EXP01-10003,5533,6688,1427,5261
CLM01-1001241,EXP01-10001,9569,7173,5058,2115
CLM01-1006526,EXP01-10002,3110,3514,1517,1997
CLM01-1006557,EXP01-10002,7570,1478,1186,292
CLM01-1002242,EXP01-10004,5586,3119,3090,29
CLM01-1004595,EXP01-10004,5210,7921,6883,1038
CLM01-1008368,EXP01-10001,3625,7793,3762,4031
CLM01-1010256,EXP01-10005,1092,8954,8155,799
CLM01-1009483,EXP01-10004,5120,7686,539,7147
CLM01-1007527,EXP01-10002,2617,4300,726,3574
CLM01-1006754,EXP01-10005,784,5048,4163,885
CLM01-1009133,EXP01-10005,3013,1804,1299,505
CLM01-1010480,EXP01-10005,3862,4051,3405,646
CLM01-1005268,EXP01-10001,3980,8949,5954,2995
CLM01-1001973,EXP01-10002,7525,8567,7048,1519
CLM01-1000518,EXP01-10002,6210,1163,993,170
CLM01-1000305,EXP01-10003,823,8752,4721,4031
CLM01-1004390,EXP01-10005,8176,6304,3922,2382
CLM01-1004641,EXP01-10005,3888,1366,1174,192
CLM01-1000053,EXP01-10003,2498,9716,960,8756
CLM01-1009764,EXP01-10004,1090,2982,2836,146
CLM01-1008071,EXP01-10005,6772,1052,764,288
CLM01-1003283,EXP01-10001,8158,6829,3510,3319
CLM01-1003396,EXP01-10005,3931,4174,3120,1054
CLM01-1001381,EXP01-10003,8120,3260,931,2329
CLM01-1009375,EXP01-10004,5982,9992,7396,2596
CLM01-1009685,EXP01-10004,3011,5018,853,4165
CLM01-1007464,EXP01-10002,7325,2773,2609,164
CLM01-1008207,EXP01-10002,4048,2260,1987,273
CLM01-1007842,EXP01-10001,2265,8529,7158,1371
CLM01-1006787,EXP01-10005,3338,5183,3655,1528
CLM01-1009944,EXP01-10002,6132,4063,1964,2099
CLM01-1002590,EXP01-10004,7932,4422,2921,1501
CLM01-1000481,EXP01-10005,7523,6899,3830,3069
CLM01-1001109,EXP01-10005,3613,4974,1680,3294
CLM01-1005860,EXP01-10001,6715,2972,2496,476
CLM01-1010432,EXP01-10005,9095,3676,2891,785
CLM01-1001313,EXP01-10005,4047,1014,925,89
CLM01-1000002,EXP01-10001,721,6253,5424,829
CLM01-1002802,EXP01-10004,8970,1344,683,661
CLM01-1010069,EXP01-10001,4173,903,535,368
CLM01-1001406,EXP01-10004,1967,2873,1925,948
CLM01-1007295,EXP01-10002,3387,2864,2682,182
CLM01-1005504,EXP01-10004,8556,7083,4114,2969
CLM01-1001515,EXP01-10003,4799,8931,5861,3070
CLM01-1000803,EXP01-10005,2491,5440,2919,2521
CLM01-1010353,EXP01-10002,8346,1417,1168,249
CLM01-1007848,EXP01-10002,8754,9469,3956,5513
CLM01-1000028,EXP01-10001,7431,7372,4244,3128
CLM01-1005430,EXP01-10002,4080,1075,983,92
CLM01-1000248,EXP01-10001,4457,4165,3133,1032
CLM01-1002576,EXP01-10003,7765,3997,1319,2678
CLM01-1004295,EXP01-10005,1214,9516,3695,5821
CLM01-1007632,EXP01-10004,919,8788,5532,3256
CLM01-1010716,EXP01-10003,2614,4668,4482,186
CLM01-1005049,EXP01-10005,8552,7462,4832,2630
CLM01-1008700,EXP01-10003,7924,3207,886,2321
CLM01-1006111,EXP01-10005,8689,7821,4660,3161
CLM01-1006495,EXP01-10004,8857,3685,3515,170
CLM01-1009631,EXP01-10004,1863,2186,1927,259
CLM01-1007077,EXP01-10001,5344,8525,6088,2437
CLM01-1007269,EXP01-10005,3026,5278,5076,202
CLM01-1009129,EXP01-10004,622,9892,4374,5518
CLM01-1010635,EXP01-10005,8778,594,513,81
CLM01-1009481,EXP01-10005,7534,2464,576,1888
CLM01-1006249,EXP01-10004,5913,4046,1091,2955
CLM01-1006119,EXP01-10005,1395,8979,841,8138
CLM01-1007343,EXP01-10001,7268,3049,1186,1863
CLM01-1002571,EXP01-10001,8802,8203,6052,2151
CLM01-1005647,EXP01-10001,9030,6084,1528,4556
CLM01-1002968,EXP01-10005,7489,9733,6759,2974
CLM01-1008039,EXP01-10004,6869,6258,2728,3530
CLM01-1009871,EXP01-10001,6156,9932,5029,4903
CLM01-1007401,EXP01-10005,5373,9729,9558,171
CLM01-1000288,EXP01-10003,3887,1175,612,563
CLM01-1009908,EXP01-10001,5270,3836,3219,617
CLM01-1001174,EXP01-10001,7195,7982,3941,4041
CLM01-1003861,EXP01-10003,5415,9139,7871,1268
CLM01-1008331,EXP01-10004,3978,7469,847,6622
CLM01-1010525,EXP01-10003,8670,2609,1832,777
CLM01-1010689,EXP01-10005,8166,1964,883,1081
CLM01-1010855,EXP01-10004,5025,502,501,1
CLM01-1006492,EXP01-10004,581,9083,7659,1424
CLM01-1004672,EXP01-10003,8656,2802,2295,507
CLM01-1008519,EXP01-10004,3843,2649,2112,537
CLM01-1002976,EXP01-10001,1785,7026,5529,1497
CLM01-1002038,EXP01-10002,616,632,616,16
CLM01-1005803,EXP01-10002,8638,2165,855,1310
CLM01-1001546,EXP01-10003,5466,8230,4728,3502
CLM01-1003658,EXP01-10003,9336,1424,624,800
CLM01-1001268,EXP01-10005,3725,535,514,21
CLM01-1004995,EXP01-10002,533,2678,547,2131
CLM01-1003486,EXP01-10001,2869,4352,677,3675
CLM01-1000277,EXP01-10001,8464,8844,849,7995
CLM01-1009500,EXP01-10004,7043,2932,1575,1357
CLM01-1010377,EXP01-10004,6864,4798,3586,1212
CLM01-1000820,EXP01-10005,3619,5387,1680,3707
CLM01-1006322,EXP01-10002,3916,7929,5358,2571
CLM01-1003337,EXP01-10001,7928,3370,2243,1127
CLM01-1003808,EXP01-10004,8430,2757,2475,282
CLM01-1006595,EXP01-10001,1158,1734,1407,327
CLM01-1006795,EXP01-10002,6569,6837,3938,2899
CLM01-1009541,EXP01-10004,9741,2328,1769,559
CLM01-1003505,EXP01-10003,6398,7889,2539,5350
CLM01-1006446,EXP01-10004,5774,3975,3798,177
CLM01-1002563,EXP01-10001,2145,2812,885,1927
CLM01-1005645,EXP01-10003,7300,6894,2731,4163
CLM01-1001771,EXP01-10005,4501,8790,3977,4813
CLM01-1004607,EXP01-10005,3446,8393,2260,6133
CLM01-1000104,EXP01-10001,9082,2627,1649,978
CLM01-1004612,EXP01-10005,3547,6107,2836,3271
CLM01-1004687,EXP01-10004,9079,6190,4174,2016
CLM01-1010240,EXP01-10001,1286,9437,7463,1974
CLM01-1006423,EXP01-10002,8808,4675,3834,841
CLM01-1006971,EXP01-10002,9839,6278,6277,1
CLM01-1004586,EXP01-10005,4272,3295,2613,682
CLM01-1008133,EXP01-10003,7390,4826,3053,1773
CLM01-1002396,EXP01-10003,9498,9620,2995,6625
CLM01-1009784,EXP01-10002,7422,2055,1717,338
CLM01-1008744,EXP01-10002,3802,1079,589,490
CLM01-1007770,EXP01-10002,6156,2215,997,1218
CLM01-1007309,EXP01-10005,6752,3141,1966,1175
CLM01-1009290,EXP01-10001,5550,9006,5341,3665
CLM01-1002343,EXP01-10002,1038,7625,802,6823
CLM01-1008195,EXP01-10003,5712,4132,963,3169
CLM01-1002297,EXP01-10003,1909,2220,992,1228
CLM01-1010140,EXP01-10005,4591,780,650,130
CLM01-1008584,EXP01-10001,4359,5636,4949,687
CLM01-1002134,EXP01-10005,5072,9227,6567,2660
CLM01-1009371,EXP01-10005,4532,9024,7506,1518
CLM01-1005570,EXP01-10004,2140,7542,5273,2269
CLM01-1006766,EXP01-10002,1185,6422,5080,1342
CLM01-1008496,EXP01-10003,8033,5653,2658,2995
CLM01-1009541,EXP01-10004,9627,3905,913,2992
CLM01-1002082,EXP01-10002,1906,7771,3092,4679
CLM01-1001134,EXP01-10003,3597,4284,1857,2427
CLM01-1002591,EXP01-10003,8741,3970,3740,230
CLM01-1003956,EXP01-10005,1603,5328,2298,3030
CLM01-1008626,EXP01-10005,638,1651,742,909
CLM01-1006632,EXP01-10003,1082,4200,1759,2441
CLM01-1010626,EXP01-10002,4914,6294,2977,3317
CLM01-1008163,EXP01-10001,4082,5778,3961,1817
CLM01-1000125,EXP01-10001,9507,4670,1807,2863
CLM01-1006875,EXP01-10003,5780,9670,7789,1881
CLM01-1007625,EXP01-10002,3598,3355,1923,1432
CLM01-1004943,EXP01-10005,9251,8390,6098,2292
CLM01-1006976,EXP01-10002,2438,7841,6727,1114
CLM01-1007337,EXP01-10004,6513,1632,500,1132
CLM01-1003543,EXP01-10004,654,8604,4653,3951
CLM01-1009476,EXP01-10005,4194,4624,4338,286
CLM01-1001527,EXP01-10002,6503,1219,924,295
CLM01-1006790,EXP01-10003,9289,7224,3719,3505
CLM01-1000187,EXP01-10001,6632,4731,1962,2769
CLM01-1005527,EXP01-10001,6720,4224,3518,706
CLM01-1008439,EXP01-10001,9048,7397,6802,595
CLM01-1005382,EXP01-10004,3140,8829,7967,862
CLM01-1008563,EXP01-10005,9111,2017,1379,638
CLM01-1000560,EXP01-10003,3264,9096,805,8291
CLM01-1005065,EXP01-10003,7967,1491,1335,156
CLM01-1006242,EXP01-10004,750,1474,728,746
CLM01-1000769,EXP01-10002,7493,3819,3720,99
CLM01-1007194,EXP01-10001,5579,3398,3019,379
CLM01-1005909,EXP01-10005,4762,9721,1750,7971
CLM01-1003288,EXP01-10001,6680,3586,2672,914
CLM01-1006343,EXP01-10002,4980,3788,3271,517
CLM01-1008239,EXP01-10002,9454,1909,1560,349
CLM01-1001459,EXP01-10003,4440,5587,5402,185
CLM01-1004749,EXP01-10004,3475,7325,7103,222
CLM01-1001617,EXP01-10003,3356,8471,4563,3908
CLM01-1005278,EXP01-10004,5710,3839,1375,2464
CLM01-1009344,EXP01-10003,4303,4026,1661,2365
CLM01-1002225,EXP01-10005,3443,9575,7656,1919
CLM01-1005503,EXP01-10004,7066,7460,2868,4592
CLM01-1004509,EXP01-10004,2890,5513,4880,633
CLM01-1005898,EXP01-10005,3352,4943,3121,1822
CLM01-1005566,EXP01-10003,9673,2704,1524,1180
CLM01-1005199,EXP01-10005,9935,2373,1659,714
CLM01-1006849,EXP01-10002,6113,4624,4417,207
CLM01-1000222,EXP01-10002,2090,8544,5558,2986
CLM01-1005322,EXP01-10001,2639,3211,3143,68
CLM01-1006441,EXP01-10004,7140,2513,1735,778
CLM01-1000239,EXP01-10001,3816,4172,932,3240
CLM01-1003455,EXP01-10005,1089,2746,2420,326
CLM01-1002411,EXP01-10001,7512,7005,4474,2531
CLM01-1000457,EXP01-10003,8214,9312,5858,3454
CLM01-1010306,EXP01-10005,2453,5925,618,5307
CLM01-1003144,EXP01-10002,2748,1283,1219,64
CLM01-1002083,EXP01-10004,2532,2444,2069,375
CLM01-1010568,EXP01-10005,1380,6475,2178,4297
CLM01-1003120,EXP01-10001,7559,7790,1837,5953
CLM01-1009530,EXP01-10001,9164,4130,2781,1349
CLM01-1006648,EXP01-10004,2941,9418,6234,3184
CLM01-1004927,EXP01-10001,8309,6038,2406,3632
CLM01-1005214,EXP01-10003,9412,1845,1086,759
CLM01-1002401,EXP01-10001,6200,3324,544,2780
CLM01-1002197,EXP01-10003,6326,9756,2879,6877
CLM01-1004374,EXP01-10004,1233,8287,590,7697
CLM01-1000675,EXP01-10003,3738,3908,2886,1022
CLM01-1004037,EXP01-10002,1885,7510,3105,4405
CLM01-1005980,EXP01-10004,1341,3413,906,2507
CLM01-1008957,EXP01-10005,8938,8012,7682,330
CLM01-1009830,EXP01-10003,8895,3456,1681,1775
CLM01-1004797,EXP01-10004,1386,521,506,15
CLM01-1002278,EXP01-10005,3732,2817,1269,1548
CLM01-1009382,EXP01-10004,2314,1059,538,521
CLM01-1010329,EXP01-10002,7983,7524,4432,3092
CLM01-1007277,EXP01-10001,3517,8323,6994,1329
CLM01-1010876,EXP01-10002,7717,2818,2332,486
CLM01-1008108,EXP01-10004,9457,8763,3814,4949
CLM01-1003380,EXP01-10003,861,877,599,278
CLM01-1000290,EXP01-10005,9930,5453,5407,46
CLM01-1006633,EXP01-10003,7506,7823,7267,556
CLM01-1002851,EXP01-10001,1138,3788,2645,1143
CLM01-1007284,EXP01-10003,3708,4264,3475,789
CLM01-1009851,EXP01-10002,5552,6539,4576,1963
CLM01-1001645,EXP01-10005,1897,1624,1506,118
CLM01-1009867,EXP01-10004,9628,7969,5427,2542
CLM01-1008175,EXP01-10005,7879,1335,757,578
CLM01-1001697,EXP01-10003,9707,1709,629,1080
CLM01-1000258,EXP01-10003,561,9065,6328,2737
CLM01-1004588,EXP01-10001,2644,1430,534,896
CLM01-1009976,EXP01-10005,3002,8346,970,7376
CLM01-1001364,EXP01-10001,1612,7357,4110,3247
CLM01-1008463,EXP01-10001,6857,3994,3264,730
CLM01-1005513,EXP01-10003,7005,8465,4090,4375
CLM01-1003132,EXP01-10004,5145,8235,5779,2456
CLM01-1008387,EXP01-10003,4497,1807,1750,57
CLM01-1004007,EXP01-10002,7604,4240,1319,2921
CLM01-1006885,EXP01-10001,869,1808,1721,87
CLM01-1003560,EXP01-10005,8389,8628,3621,5007
CLM01-1003616,EXP01-10005,5852,3936,2406,1530
CLM01-1004829,EXP01-10004,5695,1582,1115,467
CLM01-1006474,EXP01-10002,4495,7011,4075,2936
CLM01-1002954,EXP01-10002,7565,9235,6816,2419
CLM01-1003047,EXP01-10002,7487,8265,4299,3966
CLM01-1003286,EXP01-10002,3337,5859,3848,2011
CLM01-1009762,EXP01-10004,2326,5846,788,5058
CLM01-1008026,EXP01-10005,975,1677,710,967
CLM01-1001658,EXP01-10002,7613,6477,1228,5249
CLM01-1000791,EXP01-10001,7694,1494,825,669
CLM01-1002793,EXP01-10005,9816,9160,6899,2261
CLM01-1005652,EXP01-10001,4913,7024,2023,5001
CLM01-1004719,EXP01-10001,4934,8041,6506,1535
CLM01-1000495,EXP01-10005,2464,6026,4970,1056
CLM01-1000415,EXP01-10001,1091,7490,5410,2080
CLM01-1004394,EXP01-10004,4455,5059,2472,2587
CLM01-1003756,EXP01-10002,2572,3746,1211,2535
CLM01-1007499,EXP01-10001,1924,4213,3688,525
CLM01-1008080,EXP01-10001,6139,6942,5534,1408
CLM01-1005906,EXP01-10003,2735,2125,1940,185
CLM01-1005582,EXP01-10005,5497,6649,2518,4131
CLM01-1000822,EXP01-10002,5372,6018,2839,3179
CLM01-1001732,EXP01-10001,9630,6655,904,5751
CLM01-1010263,EXP01-10002,3073,3264,1743,1521
CLM01-1007416,EXP01-10005,8048,2099,789,1310
CLM01-1003994,EXP01-10005,5761,5427,1032,4395
CLM01-1001435,EXP01-10004,6560,1836,1648,188
CLM01-1004052,EXP01-10003,1015,6026,3469,2557
CLM01-1005230,EXP01-10002,5358,4622,3631,991
CLM01-1003074,EXP01-10005,6347,5050,1807,3243
CLM01-1004460,EXP01-10001,8435,3195,2042,1153
CLM01-1004988,EXP01-10002,4552,2917,2902,15
CLM01-1004839,EXP01-10005,7447,5482,821,4661
CLM01-1001730,EXP01-10001,1081,9438,8758,680
CLM01-1002051,EXP01-10005,2751,2497,1952,545
CLM01-1005709,EXP01-10003,4734,4296,3626,670
CLM01-1010569,EXP01-10005,3915,7988,3924,4064
CLM01-1008057,EXP01-10005,8948,7013,6390,623
CLM01-1000867,EXP01-10004,6014,4750,3675,1075
CLM01-1002847,EXP01-10004,1206,5131,3775,1356
CLM01-1000173,EXP01-10004,5837,2675,1808,867
CLM01-1006408,EXP01-10001,3640,6100,5338,762
CLM01-1004116,EXP01-10003,4189,4745,1234,3511
CLM01-1005927,EXP01-10003,9202,655,536,119
CLM01-1001540,EXP01-10001,8000,9885,4140,5745
CLM01-1003665,EXP01-10002,8689,6900,822,6078
CLM01-1004144,EXP01-10004,7275,4342,906,3436
CLM01-1000809,EXP01-10004,1826,5691,520,5171
CLM01-1010973,EXP01-10005,4119,6237,3526,2711
CLM01-1005925,EXP01-10003,9051,4998,1736,3262
CLM01-1005169,EXP01-10001,1714,9742,7920,1822
CLM01-1007243,EXP01-10002,7163,9661,4986,4675
CLM01-1008595,EXP01-10004,6998,947,506,441
CLM01-1009635,EXP01-10004,8552,5619,917,4702
CLM01-1001272,EXP01-10001,3086,1483,742,741
CLM01-1001051,EXP01-10003,8788,5620,4002,1618
CLM01-1002881,EXP01-10003,8419,1856,1618,238
CLM01-1001322,EXP01-10002,4333,9455,3997,5458
CLM01-1008433,EXP01-10002,8316,4597,4113,484
CLM01-1000436,EXP01-10002,9351,7399,7112,287
CLM01-1007353,EXP01-10001,6377,9209,6945,2264
CLM01-1002772,EXP01-10001,1042,2281,1874,407
CLM01-1008372,EXP01-10003,9076,2235,656,1579
CLM01-1006589,EXP01-10003,9232,2027,926,1101
CLM01-1008357,EXP01-10005,2026,9977,839,9138
CLM01-1001290,EXP01-10003,7538,5230,4664,566
CLM01-1002972,EXP01-10002,7849,689,574,115
CLM01-1007796,EXP01-10005,9977,9513,4964,4549
CLM01-1004446,EXP01-10003,7593,4743,782,3961
CLM01-1001595,EXP01-10003,6467,6500,4196,2304
CLM01-1004644,EXP01-10004,4936,8823,4153,4670
CLM01-1007950,EXP01-10004,3685,3231,2153,1078
CLM01-1002992,EXP01-10005,4013,7830,1602,6228
CLM01-1010649,EXP01-10001,6932,8365,4963,3402
CLM01-1009810,EXP01-10005,8262,3086,2473,613
CLM01-1007020,EXP01-10003,2461,8785,3386,5399
CLM01-1003841,EXP01-10005,7152,2570,1207,1363
CLM01-1005301,EXP01-10004,6343,6114,5330,784
CLM01-1007730,EXP01-10001,6336,3826,1873,1953
CLM01-1009223,EXP01-10001,7542,4685,1852,2833
CLM01-1003017,EXP01-10003,585,6517,4536,1981
CLM01-1009035,EXP01-10002,1653,7686,6669,1017
CLM01-1006096,EXP01-10002,5037,5045,4046,999
CLM01-1009738,EXP01-10003,9550,5082,2998,2084
CLM01-1004212,EXP01-10005,8372,6164,1532,4632
CLM01-1000549,EXP01-10002,7565,9315,1789,7526
CLM01-1001823,EXP01-10005,7214,5834,4653,1181
CLM01-1003742,EXP01-10005,2744,2063,2058,5
CLM01-1009873,EXP01-10002,6363,8101,2259,5842
CLM01-1008105,EXP01-10004,3301,9716,3587,6129
CLM01-1002105,EXP01-10001,7842,2812,1877,935
CLM01-1000702,EXP01-10003,6520,6935,5668,1267
CLM01-1009290,EXP01-10001,4112,8631,1593,7038
CLM01-1004807,EXP01-10003,8199,5996,2850,3146
CLM01-1003138,EXP01-10003,9868,6773,1086,5687
CLM01-1007579,EXP01-10003,5303,3898,933,2965
CLM01-1010058,EXP01-10002,8326,5844,4960,884
CLM01-1010498,EXP01-10001,8566,5424,2421,3003
CLM01-1007807,EXP01-10003,2393,1124,649,475
CLM01-1010795,EXP01-10003,3830,3927,2284,1643
CLM01-1002162,EXP01-10002,1082,3988,539,3449
CLM01-1001608,EXP01-10003,1301,5448,738,4710
CLM01-1008138,EXP01-10005,5129,4642,3786,856
CLM01-1009789,EXP01-10004,1227,808,705,103
CLM01-1004830,EXP01-10001,1565,5221,2444,2777
CLM01-1007482,EXP01-10005,6518,1837,1157,680
CLM01-1008167,EXP01-10002,6869,2512,662,1850
CLM01-1002876,EXP01-10001,7852,8726,5809,2917
CLM01-1005390,EXP01-10003,4734,3326,2549,777
CLM01-1005676,EXP01-10005,3156,3677,3138,539
CLM01-1009826,EXP01-10005,1936,8923,5925,2998
CLM01-1010073,EXP01-10001,5983,5546,5403,143
CLM01-1008901,EXP01-10003,768,8835,4888,3947
CLM01-1006342,EXP01-10002,3978,3411,3063,348
CLM01-1010577,EXP01-10004,3346,2105,1246,859
CLM01-1008278,EXP01-10004,2397,5166,1173,3993
CLM01-1008829,EXP01-10005,8816,1039,895,144
CLM01-1003162,EXP01-10005,1052,609,564,45
CLM01-1006846,EXP01-10001,4073,6268,1437,4831
CLM01-1000781,EXP01-10003,3329,5574,1842,3732
CLM01-1009362,EXP01-10003,2160,2021,801,1220
CLM01-1007949,EXP01-10005,6318,8042,4940,3102
CLM01-1006903,EXP01-10001,2247,4639,3586,1053
CLM01-1007813,EXP01-10003,614,6605,5422,1183
CLM01-1000754,EXP01-10003,9963,2609,2213,396
CLM01-1000824,EXP01-10003,5805,7332,2091,5241
CLM01-1006185,EXP01-10004,6715,7638,4331,3307
CLM01-1000749,EXP01-10002,9903,1778,891,887
CLM01-1009075,EXP01-10002,2400,7376,5287,2089
CLM01-1002809,EXP01-10003,6987,5308,1798,3510
CLM01-1006683,EXP01-10003,6640,617,561,56
CLM01-1007866,EXP01-10004,5332,7568,4526,3042
CLM01-1002877,EXP01-10002,9761,9593,3492,6101
CLM01-1002198,EXP01-10005,2084,9842,1942,7900
CLM01-1001493,EXP01-10004,1791,3558,2568,990
CLM01-1004571,EXP01-10005,9197,8546,1857,6689
CLM01-1006071,EXP01-10002,4955,1874,1820,54
CLM01-1001278,EXP01-10004,861,7624,7225,399
CLM01-1001257,EXP01-10001,1081,9704,2096,7608
CLM01-1008258,EXP01-10004,2217,2182,1536,646
CLM01-1006625,EXP01-10003,4470,2593,1729,864
CLM01-1010746,EXP01-10004,5113,5306,3436,1870
CLM01-1006575,EXP01-10001,6716,7286,952,6334
CLM01-1007982,EXP01-10005,7986,9653,1220,8433
CLM01-1007947,EXP01-10002,2589,1920,1034,886
CLM01-1003274,EXP01-10005,1969,2593,1027,1566
CLM01-1010217,EXP01-10002,9716,3233,2050,1183
CLM01-1002823,EXP01-10002,1183,1302,998,304
CLM01-1008460,EXP01-10002,2044,1036,1031,5
CLM01-1008883,EXP01-10003,6944,7522,7503,19
CLM01-1005095,EXP01-10005,3997,8805,1613,7192
CLM01-1006168,EXP01-10005,9567,5617,4776,841
CLM01-1010000,EXP01-10002,3727,1124,1095,29
CLM01-1001153,EXP01-10003,2387,5979,5772,207
CLM01-1008695,EXP01-10005,6971,2980,1883,1097
CLM01-1000315,EXP01-10003,1466,4719,2405,2314
CLM01-1005109,EXP01-10004,4830,3855,3744,111
CLM01-1009771,EXP01-10002,6817,8359,1772,6587
CLM01-1001605,EXP01-10001,4336,6277,642,5635
CLM01-1005699,EXP01-10002,605,2547,792,1755
CLM01-1006288,EXP01-10004,6870,3236,1701,1535
CLM01-1002421,EXP01-10002,4423,4545,1796,2749
CLM01-1003996,EXP01-10001,9411,9279,5855,3424
CLM01-1003351,EXP01-10003,997,6484,4280,2204
CLM01-1004917,EXP01-10002,5740,9700,3703,5997
CLM01-1000318,EXP01-10004,4145,6727,510,6217
CLM01-1003494,EXP01-10003,8272,557,517,40
CLM01-1002546,EXP01-10004,697,1249,616,633
CLM01-1003770,EXP01-10005,1624,5312,1969,3343
CLM01-1010129,EXP01-10005,6555,4728,3177,1551
CLM01-1004424,EXP01-10004,7829,5113,5030,83
CLM01-1000333,EXP01-10001,3173,8589,7227,1362
CLM01-1005355,EXP01-10003,1537,4718,2891,1827
CLM01-1000466,EXP01-10001,768,4244,2645,1599
CLM01-1001912,EXP01-10004,7920,2135,961,1174
CLM01-1010854,EXP01-10005,1279,3956,1396,2560
CLM01-1008471,EXP01-10003,3301,7124,2123,5001
CLM01-1006908,EXP01-10003,7119,6870,5822,1048
CLM01-1007691,EXP01-10004,5492,8596,5986,2610
CLM01-1004645,EXP01-10003,6862,1868,777,1091
CLM01-1004382,EXP01-10001,911,8234,5657,2577
CLM01-1001237,EXP01-10005,9199,4346,3948,398
CLM01-1002695,EXP01-10002,2650,2022,1173,849
CLM01-1008399,EXP01-10005,4014,8123,1625,6498
CLM01-1009742,EXP01-10003,7551,2161,971,1190
CLM01-1008831,EXP01-10002,6633,2928,810,2118
CLM01-1009567,EXP01-10004,3607,9414,8392,1022
CLM01-1002159,EXP01-10001,1573,5368,3079,2289
CLM01-1006422,EXP01-10004,7344,886,704,182
CLM01-1009826,EXP01-10005,6924,8940,7880,1060
CLM01-1005363,EXP01-10004,9937,2961,2774,187
CLM01-1008890,EXP01-10002,918,4022,1301,2721
CLM01-1002645,EXP01-10005,7279,2122,872,1250
CLM01-1006823,EXP01-10001,8040,2541,1969,572
CLM01-1001880,EXP01-10001,6999,1330,1318,12
CLM01-1000356,EXP01-10001,8212,2877,2383,494
CLM01-1003537,EXP01-10002,7595,5411,1161,4250
CLM01-1007595,EXP01-10001,5781,8593,8370,223
CLM01-1007566,EXP01-10005,4809,8747,6269,2478
CLM01-1003373,EXP01-10003,2763,6217,3457,2760
CLM01-1002595,EXP01-10001,2715,7036,2501,4535
CLM01-1002075,EXP01-10003,1893,9353,560,8793
CLM01-1005854,EXP01-10003,2883,2894,1558,1336
CLM01-1000854,EXP01-10004,3546,2342,2183,159
CLM01-1009579,EXP01-10001,2136,810,643,167
CLM01-1006621,EXP01-10003,1309,1395,1003,392
CLM01-1008751,EXP01-10002,7731,8879,3829,5050
CLM01-1003894,EXP01-10005,5582,631,512,119
CLM01-1006317,EXP01-10003,7816,9598,6260,3338
CLM01-1010238,EXP01-10004,1018,2921,2301,620
CLM01-1001927,EXP01-10004,5505,4533,3756,777
CLM01-1004176,EXP01-10001,6891,1933,1665,268
CLM01-1008748,EXP01-10002,3290,1558,545,1013
CLM01-1010673,EXP01-10002,5782,2740,2247,493
CLM01-1008559,EXP01-10005,6164,5936,720,5216
CLM01-1005078,EXP01-10005,8907,7782,594,7188
CLM01-1007279,EXP01-10004,8738,8335,6735,1600
CLM01-1003021,EXP01-10004,8847,7638,1735,5903
CLM01-1007144,EXP01-10003,2067,1173,1052,121
CLM01-1007771,EXP01-10005,2892,2418,676,1742
CLM01-1006970,EXP01-10002,2462,4091,1512,2579
CLM01-1000144,EXP01-10001,5572,3230,1667,1563
CLM01-1007478,EXP01-10002,2155,1378,1319,59
CLM01-1008871,EXP01-10004,6955,5642,996,4646
CLM01-1001550,EXP01-10001,9878,7944,836,7108
CLM01-1004334,EXP01-10001,3104,5153,1264,3889
CLM01-1000018,EXP01-10005,8060,8541,2209,6332
CLM01-1006556,EXP01-10004,9101,6338,3990,2348
CLM01-1009735,EXP01-10004,737,4183,1123,3060
CLM01-1002914,EXP01-10003,3470,6716,3321,3395
CLM01-1000535,EXP01-10005,9079,8210,3720,4490
CLM01-1003599,EXP01-10002,9633,7841,6252,1589
CLM01-1009535,EXP01-10004,9345,2206,1342,864
CLM01-1009781,EXP01-10003,710,2587,1529,1058
CLM01-1004771,EXP01-10001,8289,8440,8332,108
CLM01-1000456,EXP01-10004,742,1876,1102,774
CLM01-1008393,EXP01-10003,8808,9847,4926,4921
CLM01-1006661,EXP01-10004,1450,1248,1211,37
CLM01-1007624,EXP01-10004,3652,5669,1091,4578
CLM01-1002267,EXP01-10002,7557,4002,3055,947
CLM01-1004571,EXP01-10005,5863,4578,3499,1079
CLM01-1007673,EXP01-10003,6323,4459,4231,228
CLM01-1006890,EXP01-10005,8381,5268,5026,242
CLM01-1007186,EXP01-10004,8645,2768,2750,18
CLM01-1010180,EXP01-10001,8912,1282,1175,107
CLM01-1000813,EXP01-10005,5927,3479,1355,2124
CLM01-1010417,EXP01-10004,1033,4248,1292,2956
CLM01-1007783,EXP01-10005,3490,5425,5297,128
CLM01-1003666,EXP01-10002,9171,7346,3793,3553
CLM01-1007547,EXP01-10001,9611,5764,4625,1139
CLM01-1004292,EXP01-10002,1002,8969,4524,4445
CLM01-1007383,EXP01-10005,1312,8395,2617,5778
CLM01-1009172,EXP01-10003,7448,1641,937,704
CLM01-1009783,EXP01-10002,4268,6123,1185,4938
CLM01-1003166,EXP01-10002,4657,991,946,45
CLM01-1006238,EXP01-10004,3782,9106,7376,1730
CLM01-1002694,EXP01-10005,1781,5101,5090,11
CLM01-1009597,EXP01-10005,6429,1029,749,280
CLM01-1006335,EXP01-10001,3526,4452,1130,3322
CLM01-1007608,EXP01-10005,667,2453,1051,1402
CLM01-1001687,EXP01-10002,2593,4756,752,4004
CLM01-1004981,EXP01-10002,9189,7098,2071,5027
CLM01-1009626,EXP01-10001,7819,7258,3601,3657
CLM01-1005921,EXP01-10004,8229,3427,2991,436
CLM01-1009308,EXP01-10001,1644,9242,9142,100
CLM01-1002119,EXP01-10002,1618,3785,2542,1243
CLM01-1001072,EXP01-10004,8073,3792,1476,2316
CLM01-1008332,EXP01-10003,5980,8780,2093,6687
CLM01-1009810,EXP01-10005,1406,9404,3643,5761
CLM01-1006494,EXP01-10001,4132,3713,2084,1629
CLM01-1006901,EXP01-10002,6173,8489,1296,7193
CLM01-1010183,EXP01-10005,4198,2240,1588,652
CLM01-1008692,EXP01-10003,3636,1208,740,468
CLM01-1003501,EXP01-10002,8777,1234,1179,55
CLM01-1009608,EXP01-10002,2716,9379,3218,6161
CLM01-1005560,EXP01-10002,5120,6230,4236,1994
CLM01-1008175,EXP01-10005,1266,3405,2818,587
CLM01-1003212,EXP01-10004,5942,4068,2208,1860
CLM01-1001176,EXP01-10004,1596,1099,998,101
CLM01-1005150,EXP01-10004,6795,6339,2190,4149
CLM01-1007288,EXP01-10004,5768,7239,6405,834
CLM01-1002283,EXP01-10002,7465,6630,4132,2498
CLM01-1008042,EXP01-10003,1528,9222,2938,6284
CLM01-1009269,EXP01-10005,800,3252,2640,612
CLM01-1004045,EXP01-10001,778,6533,668,5865
CLM01-1007704,EXP01-10002,9551,7979,4395,3584
CLM01-1003546,EXP01-10004,2104,7085,4059,3026
CLM01-1004890,EXP01-10003,6105,5639,1138,4501
CLM01-1010944,EXP01-10001,2007,3040,1735,1305
CLM01-1003381,EXP01-10002,3283,4950,2247,2703
CLM01-1007357,EXP01-10004,8184,1642,815,827
CLM01-1005221,EXP01-10001,4459,8053,3289,4764
CLM01-1003119,EXP01-10003,2413,9908,8253,1655
CLM01-1004554,EXP01-10005,9691,1690,1309,381
CLM01-1000024,EXP01-10004,1823,7431,7024,407
CLM01-1007022,EXP01-10003,9215,8408,823,7585
CLM01-1008835,EXP01-10001,5928,8286,8155,131
CLM01-1000382,EXP01-10001,9311,9524,3011,6513
CLM01-1003685,EXP01-10001,1806,5580,1072,4508
CLM01-1005938,EXP01-10005,5381,3953,2344,1609
CLM01-1004584,EXP01-10002,9464,4730,2008,2722
CLM01-1007001,EXP01-10002,5323,2321,1814,507
CLM01-1002307,EXP01-10002,4946,6548,2652,3896
CLM01-1010262,EXP01-10005,9941,2019,1106,913
CLM01-1006361,EXP01-10002,9923,5730,5613,117
CLM01-1002353,EXP01-10001,6963,7442,6747,695
CLM01-1007611,EXP01-10003,4122,2439,1924,515
CLM01-1003780,EXP01-10002,5160,3848,3528,320
CLM01-1008206,EXP01-10005,2845,6219,513,5706
CLM01-1002910,EXP01-10001,6361,6158,1297,4861
CLM01-1003576,EXP01-10001,1383,3004,2817,187
CLM01-1010295,EXP01-10003,4322,9224,8443,781
CLM01-1004401,EXP01-10004,7049,3275,2400,875
CLM01-1005632,EXP01-10001,6308,8922,6671,2251
CLM01-1003835,EXP01-10005,9663,5601,2266,3335
CLM01-1006766,EXP01-10002,1864,9986,9757,229
CLM01-1001946,EXP01-10004,5862,718,539,179
CLM01-1003386,EXP01-10001,9929,6801,2493,4308
CLM01-1001303,EXP01-10004,3063,7491,6016,1475
CLM01-1009286,EXP01-10004,1042,7892,1511,6381
CLM01-1002931,EXP01-10002,8991,1742,671,1071
CLM01-1001689,EXP01-10005,5060,4645,1645,3000
CLM01-1003215,EXP01-10001,9760,2048,1830,218
CLM01-1008895,EXP01-10001,7033,3746,2536,1210
CLM01-1004170,EXP01-10005,7863,9781,5186,4595
CLM01-1006088,EXP01-10004,9759,2988,2762,226
CLM01-1009517,EXP01-10004,2834,5568,4108,1460
CLM01-1007243,EXP01-10002,7933,5087,4907,180
CLM01-1006853,EXP01-10003,8667,7191,3480,3711
CLM01-1000020,EXP01-10004,5203,9685,7336,2349
CLM01-1007007,EXP01-10002,7833,5676,5161,515
CLM01-1000955,EXP01-10004,8247,4770,588,4182
CLM01-1004549,EXP01-10004,5130,9952,1964,7988
CLM01-1009097,EXP01-10005,7503,9746,1870,7876
CLM01-1003494,EXP01-10003,4088,8496,8436,60
CLM01-1009493,EXP01-10001,5500,1938,1000,938
CLM01-1005883,EXP01-10002,9487,5268,2702,2566
CLM01-1001816,EXP01-10004,7771,6655,2030,4625
CLM01-1005551,EXP01-10003,9049,8196,2862,5334
CLM01-1004798,EXP01-10003,9151,6010,3793,2217
CLM01-1008499,EXP01-10002,8737,877,833,44
CLM01-1008747,EXP01-10003,5400,561,554,7
CLM01-1000780,EXP01-10001,6476,2534,1238,1296
CLM01-1009265,EXP01-10002,6041,3100,2265,835
CLM01-1003475,EXP01-10004,2145,792,710,82
CLM01-1001756,EXP01-10003,3997,5009,735,4274
CLM01-1010907,EXP01-10001,2386,3084,1875,1209
CLM01-1009421,EXP01-10005,5344,3269,3220,49
CLM01-1000537,EXP01-10001,6625,5883,5478,405
CLM01-1010008,EXP01-10005,9242,3532,1088,2444
CLM01-1004153,EXP01-10001,6000,5196,2268,2928
CLM01-1009326,EXP01-10004,2541,2005,1251,754
CLM01-1000593,EXP01-10001,8434,7931,2889,5042
CLM01-1006637,EXP01-10002,7085,4755,978,3777
CLM01-1006693,EXP01-10001,4994,2999,647,2352
CLM01-1009439,EXP01-10003,4222,823,782,41
CLM01-1004449,EXP01-10003,1628,3226,1146,2080
CLM01-1003232,EXP01-10004,5568,6546,919,5627
CLM01-1007313,EXP01-10001,3840,4343,1135,3208
CLM01-1003416,EXP01-10003,6426,2621,2538,83
CLM01-1009210,EXP01-10004,4505,9077,938,8139
CLM01-1009119,EXP01-10005,8487,5483,3935,1548
CLM01-1002005,EXP01-10004,4138,9063,1582,7481
CLM01-1003955,EXP01-10003,6641,9845,1347,8498
CLM01-1003064,EXP01-10004,8161,4425,1062,3363
CLM01-1004153,EXP01-10001,7665,7362,531,6831
CLM01-1004717,EXP01-10005,6716,9404,5846,3558
CLM01-1002788,EXP01-10004,2537,7680,623,7057
CLM01-1005445,EXP01-10001,2705,9874,3948,5926
CLM01-1009385,EXP01-10005,765,4233,1626,2607
CLM01-1008315,EXP01-10003,3095,6444,2860,3584
CLM01-1003325,EXP01-10001,3641,4986,3849,1137
CLM01-1002874,EXP01-10001,1748,9268,3033,6235
CLM01-1004505,EXP01-10004,9964,8843,6604,2239
CLM01-1010080,EXP01-10004,9662,5627,3593,2034
CLM01-1002205,EXP01-10004,6856,5919,4231,1688
CLM01-1005308,EXP01-10005,3106,2694,1405,1289
CLM01-1005918,EXP01-10003,7826,4871,617,4254
CLM01-1000906,EXP01-10005,3056,7538,5427,2111
CLM01-1010204,EXP01-10005,8962,2651,715,1936
CLM01-1004684,EXP01-10004,2042,8494,4337,4157
CLM01-1002388,EXP01-10005,9404,5136,2463,2673
CLM01-1007569,EXP01-10001,6328,8216,1413,6803
CLM01-1006241,EXP01-10002,1214,585,506,79
CLM01-1010921,EXP01-10002,5319,5978,3068,2910
CLM01-1004618,EXP01-10004,1516,3238,2917,321
CLM01-1006746,EXP01-10005,5880,992,942,50
CLM01-1000802,EXP01-10005,4874,9570,5216,4354
CLM01-1001841,EXP01-10004,8572,5385,2778,2607
CLM01-1004081,EXP01-10001,6482,7997,2634,5363
CLM01-1007949,EXP01-10005,978,8945,8201,744
CLM01-1004160,EXP01-10003,5053,584,537,47
CLM01-1007510,EXP01-10001,7548,4403,4133,270
CLM01-1004309,EXP01-10004,1752,1416,1292,124
CLM01-1002442,EXP01-10005,1368,2902,2817,85
CLM01-1003589,EXP01-10002,9449,8802,3178,5624
CLM01-1000877,EXP01-10002,5341,7901,5947,1954
CLM01-1008564,EXP01-10005,1489,1822,621,1201
CLM01-1005061,EXP01-10002,9463,5650,3234,2416
CLM01-1002308,EXP01-10003,4619,1419,1171,248
CLM01-1005978,EXP01-10003,7271,7072,4151,2921
CLM01-1006010,EXP01-10001,9142,4752,3838,914
CLM01-1002168,EXP01-10003,5408,3777,1560,2217
CLM01-1009070,EXP01-10005,3088,6056,5822,234
CLM01-1010185,EXP01-10004,6765,5084,661,4423
CLM01-1004350,EXP01-10001,4775,7821,7486,335
CLM01-1005347,EXP01-10003,4212,7851,1800,6051
CLM01-1005331,EXP01-10003,9085,5691,2566,3125
CLM01-1001165,EXP01-10001,8735,1931,842,1089
CLM01-1003785,EXP01-10001,3343,4025,2049,1976
CLM01-1005571,EXP01-10001,8716,1672,1383,289
CLM01-1003236,EXP01-10002,2658,1139,775,364
CLM01-1006053,EXP01-10004,8530,4798,3853,945
CLM01-1008741,EXP01-10002,3219,3103,2128,975
CLM01-1003079,EXP01-10002,3534,3519,2174,1345
CLM01-1008867,EXP01-10002,2517,8488,3264,5224
CLM01-1004057,EXP01-10003,7196,9609,5637,3972
CLM01-1004409,EXP01-10003,3310,6827,6002,825
CLM01-1002435,EXP01-10005,687,8526,4816,3710
CLM01-1010149,EXP01-10004,9042,5097,3475,1622
CLM01-1007193,EXP01-10002,616,6552,744,5808
CLM01-1007267,EXP01-10005,2066,3390,1161,2229
CLM01-1005288,EXP01-10003,1431,8274,516,7758
CLM01-1007124,EXP01-10003,5346,4893,3817,1076
CLM01-1010129,EXP01-10005,2238,8935,732,8203
CLM01-1007049,EXP01-10001,7091,7471,547,6924
CLM01-1004860,EXP01-10003,9356,989,631,358
CLM01-1006254,EXP01-10002,9181,2456,1649,807
CLM01-1003924,EXP01-10004,2213,1745,1546,199
CLM01-1002354,EXP01-10003,1707,5697,2133,3564
CLM01-1007604,EXP01-10003,3186,9684,1639,8045
CLM01-1010237,EXP01-10001,2252,9951,2286,7665
CLM01-1001820,EXP01-10004,2081,8461,1392,7069
CLM01-1009273,EXP01-10003,8366,6356,1258,5098
CLM01-1004574,EXP01-10002,3739,2680,1128,1552
CLM01-1005921,EXP01-10004,6824,3381,2165,1216
CLM01-1010262,EXP01-10005,9952,8908,1108,7800
CLM01-1007142,EXP01-10005,6772,7066,3180,3886
CLM01-1010748,EXP01-10004,8087,1314,864,450
CLM01-1004708,EXP01-10005,777,7300,1387,5913
CLM01-1004781,EXP01-10002,5652,710,545,165
CLM01-1008092,EXP01-10002,9500,3501,1223,2278
CLM01-1002565,EXP01-10003,3358,9821,4228,5593
CLM01-1010342,EXP01-10001,7674,7986,5829,2157
CLM01-1010192,EXP01-10002,8405,1083,885,198
CLM01-1009907,EXP01-10002,8878,7789,2045,5744
CLM01-1005275,EXP01-10005,9082,5468,3282,2186
CLM01-1001473,EXP01-10001,5253,5841,5473,368
CLM01-1008729,EXP01-10004,1762,8992,807,8185
CLM01-1005442,EXP01-10003,1144,4090,4007,83
CLM01-1002553,EXP01-10004,8712,1001,788,213
CLM01-1004510,EXP01-10005,7823,3161,1665,1496
CLM01-1010465,EXP01-10004,3998,5491,4621,870
CLM01-1006697,EXP01-10001,9813,2061,1904,157
CLM01-1006384,EXP01-10004,7686,9391,3189,6202
CLM01-1007594,EXP01-10002,1987,7365,6069,1296
CLM01-1009460,EXP01-10001,7911,7958,2533,5425
CLM01-1001803,EXP01-10001,3447,7386,3783,3603
CLM01-1003427,EXP01-10004,6246,2311,1890,421
CLM01-1000851,EXP01-10005,4654,3675,863,2812
CLM01-1010142,EXP01-10005,9760,1798,1221,577
CLM01-1005704,EXP01-10005,2277,8303,4973,3330
CLM01-1009746,EXP01-10003,9919,1292,636,656
CLM01-1007003,EXP01-10005,6745,7725,2742,4983
CLM01-1005454,EXP01-10002,2176,4338,3978,360
CLM01-1001308,EXP01-10002,3967,9322,4335,4987
CLM01-1008498,EXP01-10003,7786,7039,960,6079
CLM01-1006244,EXP01-10005,5737,5961,3186,2775
CLM01-1008645,EXP01-10002,682,9006,7646,1360
CLM01-1008391,EXP01-10001,5980,9288,3107,6181
CLM01-1004828,EXP01-10003,5906,8941,1217,7724
CLM01-1009121,EXP01-10005,4558,9974,5783,4191
CLM01-1006864,EXP01-10004,4706,1005,644,361
CLM01-1000324,EXP01-10005,7780,2397,1784,613
CLM01-1001803,EXP01-10001,5925,1251,1017,234
CLM01-1004676,EXP01-10002,4906,938,869,69
CLM01-1010238,EXP01-10004,8257,3062,2126,936
CLM01-1005813,EXP01-10004,9689,1409,703,706
CLM01-1000125,EXP01-10001,6075,5766,4515,1251
CLM01-1007169,EXP01-10002,1958,9194,1184,8010
CLM01-1004319,EXP01-10002,8929,2038,730,1308
CLM01-1005088,EXP01-10001,7420,9493,3776,5717
CLM01-1010681,EXP01-10004,5801,9889,1797,8092
CLM01-1006905,EXP01-10001,8183,758,613,145
CLM01-1008275,EXP01-10004,9057,3455,594,2861
CLM01-1009567,EXP01-10004,668,7913,1687,6226
CLM01-1005602,EXP01-10004,4042,4882,2054,2828
CLM01-1004961,EXP01-10002,7028,4982,4226,756
CLM01-1009200,EXP01-10003,6433,1240,1081,159
CLM01-1003309,EXP01-10003,2976,7001,594,6407
CLM01-1010111,EXP01-10003,2992,1501,620,881
CLM01-1004252,EXP01-10001,2349,902,643,259
CLM01-1003123,EXP01-10002,6044,6684,1085,5599
CLM01-1003425,EXP01-10002,9467,5755,1405,4350
CLM01-1007981,EXP01-10001,8466,4701,4611,90
CLM01-1005898,EXP01-10005,8977,682,576,106
CLM01-1008391,EXP01-10001,8941,4387,2348,2039
CLM01-1006633,EXP01-10003,1685,2747,537,2210
CLM01-1001641,EXP01-10001,3864,7506,3210,4296
CLM01-1007059,EXP01-10004,6710,2582,546,2036
CLM01-1002320,EXP01-10003,3129,5775,4760,1015
CLM01-1007823,EXP01-10003,7253,3513,1500,2013
CLM01-1006992,EXP01-10002,3260,1899,1490,409
CLM01-1010579,EXP01-10004,8623,3887,1416,2471
CLM01-1008652,EXP01-10004,8555,4862,1180,3682
CLM01-1003531,EXP01-10002,2178,2930,2619,311
CLM01-1009157,EXP01-10002,6551,5612,4896,716
CLM01-1008483,EXP01-10002,3547,3189,2848,341
CLM01-1005299,EXP01-10004,9465,2034,845,1189
CLM01-1000524,EXP01-10001,4138,4277,4067,210
CLM01-1006135,EXP01-10004,5619,6923,6490,433
CLM01-1004098,EXP01-10004,2998,1963,1845,118
CLM01-1002619,EXP01-10004,3969,1725,1202,523
CLM01-1008583,EXP01-10003,1189,5212,3702,1510
CLM01-1009992,EXP01-10003,4299,1017,962,55
CLM01-1010578,EXP01-10005,1760,9765,2420,7345
CLM01-1009166,EXP01-10005,1022,3734,1824,1910
CLM01-1004707,EXP01-10002,4405,3711,1664,2047
CLM01-1007222,EXP01-10005,7280,8549,6455,2094
CLM01-1001039,EXP01-10003,6552,7517,854,6663
CLM01-1001438,EXP01-10001,7494,4860,1985,2875
CLM01-1007188,EXP01-10004,9096,6474,3667,2807
CLM01-1006860,EXP01-10005,9650,9007,5638,3369
CLM01-1010306,EXP01-10005,2945,3161,3156,5
CLM01-1000879,EXP01-10001,745,5511,536,4975
CLM01-1009077,EXP01-10005,3915,9718,9432,286
CLM01-1003236,EXP01-10002,1341,9297,2706,6591
CLM01-1008626,EXP01-10005,5305,1978,1235,743
CLM01-1009244,EXP01-10001,6273,4195,2519,1676
CLM01-1001433,EXP01-10005,4841,9198,1930,7268
CLM01-1005686,EXP01-10003,4617,9981,2350,7631
CLM01-1007935,EXP01-10003,7246,6579,3742,2837
CLM01-1010262,EXP01-10005,1395,4424,4328,96
CLM01-1002965,EXP01-10002,1320,2623,2608,15
CLM01-1008865,EXP01-10001,9727,1773,1061,712
CLM01-1001262,EXP01-10001,6135,2522,903,1619
CLM01-1005921,EXP01-10004,2708,735,703,32
CLM01-1000652,EXP01-10003,5159,7257,1491,5766
CLM01-1008854,EXP01-10003,1834,2922,2609,313
CLM01-1001346,EXP01-10002,9925,961,649,312
CLM01-1002603,EXP01-10001,1553,6278,5717,561
CLM01-1010298,EXP01-10001,6029,9644,9118,526
CLM01-1007369,EXP01-10001,1908,9581,1373,8208
CLM01-1001021,EXP01-10005,6729,9980,8489,1491
CLM01-1002074,EXP01-10002,6060,6526,5468,1058
CLM01-1001827,EXP01-10001,5008,7560,7328,232
CLM01-1002029,EXP01-10004,6833,7625,4349,3276
CLM01-1006417,EXP01-10003,5646,3999,3899,100
CLM01-1009436,EXP01-10001,7461,9721,9612,109
CLM01-1002394,EXP01-10002,6447,2344,1324,1020
CLM01-1005037,EXP01-10002,6758,6608,5372,1236
CLM01-1000226,EXP01-10005,6955,2762,1164,1598
CLM01-1002164,EXP01-10004,1360,7048,5798,1250
CLM01-1009474,EXP01-10001,3098,1027,702,325
CLM01-1006659,EXP01-10004,9666,6723,5374,1349
CLM01-1009772,EXP01-10005,5262,3541,681,2860
CLM01-1005397,EXP01-10003,1047,7913,4814,3099
CLM01-1000599,EXP01-10005,7637,5777,4291,1486
CLM01-1002660,EXP01-10002,9710,3049,2479,570
CLM01-1008573,EXP01-10005,8878,4382,4075,307
CLM01-1002135,EXP01-10004,6417,2959,821,2138
CLM01-1009050,EXP01-10002,9623,7263,3796,3467
CLM01-1005043,EXP01-10004,7899,930,856,74
CLM01-1004442,EXP01-10001,3242,1071,767,304
CLM01-1001595,EXP01-10003,4398,1214,997,217
CLM01-1009393,EXP01-10003,4034,8723,1525,7198
CLM01-1003030,EXP01-10004,3069,9331,2895,6436
CLM01-1001037,EXP01-10001,1241,5341,766,4575
CLM01-1008793,EXP01-10003,8354,3713,857,2856
CLM01-1002935,EXP01-10001,8880,4111,1678,2433
CLM01-1003808,EXP01-10004,2931,2184,1388,796
CLM01-1003379,EXP01-10001,9208,1406,999,407
CLM01-1009409,EXP01-10002,7121,7154,1600,5554
CLM01-1003838,EXP01-10005,2857,7079,5201,1878
CLM01-1003737,EXP01-10005,8092,3683,3118,565
CLM01-1005978,EXP01-10003,8953,3731,870,2861
CLM01-1008024,EXP01-10001,5050,6651,6256,395
CLM01-1008021,EXP01-10004,4072,6261,3600,2661
CLM01-1000754,EXP01-10003,7765,8283,1432,6851
CLM01-1005097,EXP01-10002,1073,6058,5147,911
CLM01-1006685,EXP01-10001,1609,1518,600,918
CLM01-1009920,EXP01-10005,2371,2834,939,1895
CLM01-1006965,EXP01-10005,2152,944,681,263
CLM01-1010418,EXP01-10004,5858,2794,705,2089
CLM01-1010681,EXP01-10004,3620,4260,976,3284
CLM01-1000822,EXP01-10002,8817,8706,1768,6938
CLM01-1009663,EXP01-10002,3555,5804,915,4889
CLM01-1005010,EXP01-10004,5071,7979,7741,238
CLM01-1003691,EXP01-10004,4516,2634,1498,1136
CLM01-1006648,EXP01-10004,9849,9592,7546,2046
CLM01-1003031,EXP01-10004,7521,2150,636,1514
CLM01-1002790,EXP01-10005,9001,9133,7508,1625
CLM01-1001433,EXP01-10005,7692,5098,4215,883
CLM01-1003032,EXP01-10003,556,2997,2853,144
CLM01-1004021,EXP01-10002,3984,5280,1614,3666
CLM01-1007156,EXP01-10004,4477,8060,2914,5146
CLM01-1003812,EXP01-10004,6465,6738,2823,3915
CLM01-1000685,EXP01-10005,2036,2026,764,1262
CLM01-1000663,EXP01-10002,7686,9766,4244,5522
CLM01-1005406,EXP01-10004,9604,2051,822,1229
CLM01-1006925,EXP01-10003,1427,8676,6668,2008
CLM01-1006927,EXP01-10001,8662,1940,755,1185
CLM01-1000658,EXP01-10001,9895,3193,868,2325
CLM01-1007765,EXP01-10002,8816,9092,1938,7154
CLM01-1010110,EXP01-10001,5435,5555,4362,1193
CLM01-1004615,EXP01-10002,956,3146,1687,1459
CLM01-1001411,EXP01-10005,4068,1351,1321,30
CLM01-1004420,EXP01-10003,1019,4866,608,4258
CLM01-1004394,EXP01-10004,3612,9257,1870,7387
CLM01-1004122,EXP01-10004,4546,4219,1068,3151
CLM01-1009516,EXP01-10004,8702,7208,4482,2726
CLM01-1002604,EXP01-10001,4177,1416,1132,284
CLM01-1006049,EXP01-10005,6418,4837,3778,1059
CLM01-1006015,EXP01-10002,3724,5611,2181,3430
CLM01-1006211,EXP01-10004,8678,1842,878,964
CLM01-1009466,EXP01-10001,2748,9029,8198,831
CLM01-1006263,EXP01-10001,6267,7398,3360,4038
CLM01-1000227,EXP01-10003,7259,5632,4687,945
CLM01-1003505,EXP01-10003,1573,6028,1623,4405
CLM01-1004034,EXP01-10004,3457,4351,1188,3163
CLM01-1005443,EXP01-10001,1566,9683,5921,3762
CLM01-1008421,EXP01-10004,7257,8069,6846,1223
CLM01-1007366,EXP01-10004,4246,4826,2117,2709
CLM01-1010003,EXP01-10004,9973,1873,892,981
CLM01-1009791,EXP01-10005,2925,4961,2800,2161
CLM01-1000997,EXP01-10002,8973,4413,3303,1110
CLM01-1009034,EXP01-10005,7048,5037,1451,3586
CLM01-1004372,EXP01-10003,9057,9859,8438,1421
CLM01-1006604,EXP01-10005,7779,2947,2850,97
CLM01-1010780,EXP01-10002,910,8025,4269,3756
CLM01-1004134,EXP01-10001,5272,3263,1310,1953
CLM01-1000790,EXP01-10003,1364,8073,1831,6242
CLM01-1002913,EXP01-10002,3528,9269,7318,1951
CLM01-1010164,EXP01-10001,8016,6440,3622,2818
CLM01-1002169,EXP01-10001,7414,6119,5766,353
CLM01-1001963,EXP01-10005,8052,3956,678,3278
CLM01-1010696,EXP01-10002,8951,7880,2282,5598
CLM01-1006141,EXP01-10003,5084,8224,3059,5165
CLM01-1006819,EXP01-10004,3477,1050,839,211
CLM01-1010199,EXP01-10004,6634,9713,1019,8694
CLM01-1003220,EXP01-10004,9124,5784,4175,1609
CLM01-1010571,EXP01-10003,8579,1288,639,649
CLM01-1002251,EXP01-10004,3096,3732,3044,688
CLM01-1006000,EXP01-10005,5001,5117,4770,347
CLM01-1001650,EXP01-10002,2485,1345,858,487
CLM01-1008124,EXP01-10004,9456,7770,3633,4137
CLM01-1001177,EXP01-10002,7880,7125,1256,5869
CLM01-1007680,EXP01-10005,7614,8556,5919,2637
CLM01-1006744,EXP01-10005,3749,871,867,4
CLM01-1005293,EXP01-10001,7836,8583,6521,2062
CLM01-1006571,EXP01-10004,4620,6474,4936,1538
CLM01-1003380,EXP01-10003,8150,6782,6553,229
CLM01-1002365,EXP01-10001,2627,9327,1066,8261
CLM01-1001890,EXP01-10005,8167,6971,3484,3487
CLM01-1008696,EXP01-10001,6781,4383,3311,1072
CLM01-1002577,EXP01-10005,3668,7449,5578,1871
CLM01-1003280,EXP01-10001,977,3755,2151,1604
CLM01-1006214,EXP01-10003,3371,735,561,174
CLM01-1009591,EXP01-10004,1426,1607,1182,425
CLM01-1001262,EXP01-10001,6264,4128,3454,674
CLM01-1010315,EXP01-10002,968,7793,4656,3137
CLM01-1003599,EXP01-10002,7910,8396,8114,282
CLM01-1004442,EXP01-10001,3231,8526,1671,6855
CLM01-1009122,EXP01-10002,7042,6230,1941,4289
CLM01-1007276,EXP01-10003,9353,1069,916,153
CLM01-1003876,EXP01-10001,5160,7597,2118,5479
CLM01-1003264,EXP01-10004,5734,3717,1726,1991
CLM01-1007950,EXP01-10004,7319,8570,8505,65
CLM01-1001735,EXP01-10005,8221,3820,3716,104
CLM01-1009407,EXP01-10004,4811,7156,984,6172
CLM01-1000550,EXP01-10005,2267,932,698,234
CLM01-1004217,EXP01-10002,9585,9054,8672,382
CLM01-1001578,EXP01-10004,4839,2268,1125,1143
CLM01-1008859,EXP01-10001,4875,4013,2488,1525
CLM01-1008297,EXP01-10003,4815,9006,3248,5758
CLM01-1005456,EXP01-10003,1984,9913,8874,1039
CLM01-1009841,EXP01-10002,5652,2347,674,1673
